....................
...........e.S......
.........rbgoy......
.b.+.s..............
.ryoGBR.............
..........e.........
.........OYR........
....s.S.......eS....
....RBG...g...BGO...
.e........b.s....e..
rrbbggooyyrbgoyrbgoy
