....................
....................
....................
....................
....................
....................
.........OYR........
....................
....RBG.......BGO...
+...................
rrbbggooyyrbgoyrbgoy