....................
...........e........
.........rbgoy......
.b.+................
.ryoGBR.............
....................
.........OYR........
....................
....RBG...g...BGO...
..........b.........
rrbbggooyyrbgoyrbgoy
